11,12
0/0/57,0/0/32,0/0/32,0/0/32,0/0/32,0/0/32,0/0/32,0/0/32,0/0/32,0/0/32,0/0/54
0/0/31,0/0/6,0/0/6,0/0/6,0/0/6,0/0/6,0/0/6,0/0/6,0/0/6,0/0/6,0/0/29
0/0/31,0/0/2,0/0/2,0/0/2,0/0/2,1/3/0,0/0/2,0/0/2,0/0/2,0/0/2,0/0/29
0/0/31,0/0/1,0/0/1,1/0/0,1/0/0,1/0/0,1/0/0,1/0/0,0/0/1,1/0/105,0/0/29
0/0/31,0/0/1,1/0/0,1/0/0,1/0/0,1/0/0,1/0/0,1/0/0,1/0/0,1/5/0,0/0/29
0/0/31,0/0/1,1/0/0,1/0/0,1/0/0,1/0/0,1/0/0,1/0/0,1/0/0,0/0/1,0/0/29
0/0/31,1/2/0,1/0/0,1/0/0,1/0/0,7/0/5001,1/0/0,1/0/0,1/0/0,1/1/0,0/0/29
0/0/31,0/0/2,1/0/0,1/0/0,1/0/0,1/0/0,1/0/0,1/0/0,1/0/0,0/0/2,0/0/29
0/0/31,0/0/1,1/0/0,1/0/0,1/0/0,1/0/0,1/0/0,1/0/0,1/0/0,0/0/1,0/0/29
0/0/31,0/0/1,0/0/2,1/0/0,1/0/0,1/0/0,1/0/0,1/0/0,0/0/2,0/0/1,0/0/29
0/0/31,0/0/1,0/0/1,0/0/2,0/0/2,1/4/0,0/0/2,0/0/2,0/0/1,0/0/1,0/0/29
0/0/57,0/0/30,0/0/30,0/0/30,0/0/30,0/0/30,0/0/30,0/0/30,0/0/30,0/0/30,0/0/55
